NO ./xpm/north.xpm
SO ./xpm/south.xpm
WE ./xpm/east.xpm
EA ./xpm/west.xpm

F 220,100,0
C 225,30,0


1111110111
11111111
1100100N11
  10000101
1111111111