NO ./xpm/north.xpm
SO ./xpm/south.xpm
WE ./xpm/east.xpm
EA ./xpm/west.xpm

C 255,0,255
F				     255,1,1


    111111111111
    1001111111111111
    1000000000000011
    100000S001011111
11111000000000001111
10000111111001111
1001001   10001111111
10000011111000111111
1000000000000001111
1111111111111111111




