NO ./xpm/north.xpm
SO ./xpm/south.xpm
WE ./xpm/east.xpm
EA ./xpm/west.xpm

F 220,100,0
C 225,30,0


11111011
1111100
10N0N001
11111111