NO ./xpm/FOXX.xpm
SO ./xpm/forrest.xpm
WE ./xpm/BIG_CHAMP.xpm
EA ./xpm/TREE.xpm


C 20,10,100
F 25,0,120


111111111111111111111111111111
100000000000000000000000000001
100000000000000000000000000001
100000000000000000000000000001
100000000000000000000000000001
100000000000000000000010000001
10000000000000000000001000001
10000000000000000000001000001
100000000000000000000000000001
100000000000000000000000000001
100000000000000000000000000001
1000W00000000000000000000000001
100000000000000000000000000011
111111111111111111111111111111

111
101
111
