NO ./xpm/north.xpm
SO ./xpm/south.xpm
WE ./xpm/east.xpm
EA ./xpm/west.xpm

F 220,100,0
C 225,30,0


1111111111
1000100N01
1000000001
1111111111