NO ./xpm/north.xpm
SO ./xpm/south.xpm
WE ./xpm/east.xpm
EA ./xpm/west.xpm

C 255,120,0
F 0,50,20

1111111111111111
1000000000000001
1000000010000001
1000000010000101111
10000N0000000000001
1000000000001100111
1000000000000001
1111111111111111
