NO ./textures/wall_1.xpm
SO ./textures/wall_2.xpm
WE ./textures/wall_3.xpm
EA ./textures/wall_4.xpm
F 100,60,60
C 60,160,255

1111111111111111111
1000000000000000001
10000000N00001 1001
1000000000000010001 
1000111011100010001111
10001 101 1001 1001
111111111 1111 1111
  1